Piano: 還ラナイ声 - 岡部啓一 / 鈴木よう
告白之夜（纯音乐） - CMJ
ド屑 - なきそ
Gotta Be A Reason - Alec Benjamin
Murmuration - Blue Wednesday / Shopan
Lockdown Cafe - Oaty.
情绪挑拨 - 任然
I Love You 3000 - Stephanie Poetri
タイニーリトル・アジアンタム - ShibayanRecords
Run Free (feat. IVIE) - Deep Chills / IVIE
告白/告别 - 心_ARC / 洛天依
Angel（0.8X） - xxxCr3
龙与虎 - Seto
Don't Stop !! - Hibiki
夏風に溶ける - MAISONdes / りりあ。 / 南雲ゆうき
ラッキー☆オーブ - emon (Tes.) / 初音ミク
漂流 - 菅原纱由理（THE SxPLAY）
Cheers - MAISONdes / Tani Yuuki / 菅原圭
愛言葉IV - DECO*27 / 初音ミク
ARCADIA - ヰ世界情緒
Kiss Me More (Japanese Version) - Rainych
エイミー - ヨルシカ
i always sad but my eyes smile - L1VET..
愛を教えてくれた君へ - クアイフ
シャナ - Guiano / IA
だんだん増えてゆく - 40mP
#LC40 清新之流 - LJC一直想要一个长名字
Say So -Japanese Version- (tofubeats Remix) - Rainych / tofubeats
Say So （Japanese.Ver) - Reirei
Say So - Doja Cat
Normal No More - TYSM
Nothing Hurts Like This - Slo
Crystal Ball - Lenka
forget me not - 別野加奈
我想去拥抱微风 - J.well
Hollow - Yosh
Young And Beautiful - Lana Del Rey
L O V E - Jake Shillingford / Nicholas Evans
深海 - 森七菜
Saving Us - R!N/Gemie / SawanoHiroyuki[nZk]
Matter of Time - Shannon Hurley
Communication - The Cardigans
Not A Love Song - Bean
if - 西野カナ
失眠飞行 - 接个吻，开一枪 / 沈以诚 / 薛黛霏
纪念册 - 音阙诗听 / 王梓钰
风停了雨停了我们还拥抱着 - Superluckyqi
对玄机 - 任然 / 王梓钰
棠梨煎雪 - 银临
词不达意 - 林忆莲
孤身 - 徐秉龙
怎么唱情歌 - 刘惜君
刚烈女子 - 锦零
思人语 - 谪仙莫渐离
Illusionary Daytime - Shirfine
Whether - 化境 / 清风至 / 余日秋山 / AniFace / 余家仪
Hoaprox-Ngẫu Hứng（AJonnyCool Bootleg）（AJonnyCool remix） - 安约翰AJC
M18 - 梶浦由記
夏野与暗恋 - 闫东炜
メインテーマ「永遠の一瞬」 - 伊藤賢治
A Dead Leaf Dance - As the Stars Fall
惨劇の記憶 - 柿島伸次
Children Of The Earth(Ness's Original Re-Edit) - Ayur
Last Reincarnation - AniFace
命に嫌われている - 清予SeiYo
冷たい部屋、一人 - 小松未可子
Lost in wonderland - 辻詩音
spira - Chouchou
しゃん・だら・りん♪ - nayuta
パピヨン - fifi léger(ゆうり)
ONE - Crystal Kay
月灯りふんわり落ちてくる夜 - やなぎなぎ
朝もお昼も夢の中も - MACO
阿吽のビーツ（翻自 v_flower） - RincolF
キミじゃなきゃ - FUKI
手纸 ~拝啓 绪五の君へ~ - Naomile
ホントのキモチ - Tiara
Beautiful World - 宇多田ヒカル
片想い - miwa
intention - 鹿乃
Slow & Easy - 平井 大
Story - 西野カナ
ずっと、ふたりで - 家入レオ
最後の花弁 (The meaning of love) - EGOIST
アスノヨゾラ哨戒班。明日的夜空哨戒班（Cover IA） - Akie秋绘 / 夏璃夜
いのちの名前（Cover 平原绫香） - Akie秋绘
Tifa's Theme (From "Final Fantasy VII") [Piano Version] - Streaming Music Studios
░░_Ｓｐｒｉｎｇｔｉｍｅ  Ｓｔｒｏｌｌ_Westminster Quarters =Ⓣɪᴍᴇ ➋ Ⓜᴇᴇᴛ - secret crates
夜明け - 菊谷知樹
Cave Slimes - park bird
when we... - silky soap
let's be lazy together - biosphere
Flipper - Pasteboard
闻雨 - 尚先生
时光记忆 - 傅许
anne - Haruka Nakamura
腻味 - 金玟岐
岁月神偷 - 金玟岐
立场 - 锦零
一百万个可能 - Christine Welch
幼时 - 泽典
才华有限公司 - 金玟岐
我们俩 - 郭顶
孩子 - 金玟岐
梦返 - 黄霄雲
那时窗外开满花 - 王金金
放爱情一个假 - 萧亚轩
你的余温 - Gifty
数羊 - 旺仔小乔
惊梦 feat. Himawari - Aosaki / Himawari
Paris - Else
yellow - eel.
和煦的糖果风 - Candy_Wind
My Bitter Days - 夢乃ゆき
Call of Silence x Zero Eclipse - Samuel Kim
今日から思い出 Evergreen ver. - Aimer
inori - 坂本真綾
beauty is within us - Scott Matthew
寻天涯 - 大残
ツギハギスタッカート - nameless
happy when you're not here - In Love With A Ghost
ひらひら　ひらら - ClariS
Scarborough Fair - 山田タマル
控诉 - 小乐哥（王唯乐）
檻鶴姫 - 霜月はるか
雪の降る街 - Aimer
衝撃 - 安藤裕子
オンリー - 大原ゆい子
崩落 - 椋霁子
Pachelbel : Cannon In D Major - Johann Pachelbel
Sunrise - Catie Mckinney
Lily - RAM WIRE
A Letter - Cyua
Black Bird - ぼくのりりっくのぼうよみ
A LETTER - Aimer
FRIENDS - Marshmello / Anne-Marie
Mela! - 緑黄色社会
A LETTER <nZK Ver.> - Cyua
くらべられっ子 - ツユ
景色 - 花譜
Never Grow Up - ちゃんみな
Intro - ラブリーサマーちゃん
Twilight - Haruka Nakamura
Diamond Cut Diamond (Original Mix) - Worry Free Studios / Grimmmz / United Idol
爱上未来的你 - 刘瑞琦
初恋 - Flower
Cage <NTv> - SawanoHiroyuki[nZk] / Tielle
Cage - Tielle / SawanoHiroyuki[nZk]
银河与星斗 - 什么琪
11月の雨 - CHiCO with HoneyWorks
いつかこの涙が - Little Glee Monster
言って。 - ヨルシカ
花に亡霊 - ヨルシカ
银河与星斗 - yihuik苡慧
梦遇 - 洛天依 / 乐正绫 / 闹闹丶
君がいて水になる - ずっと真夜中でいいのに。
lost[2010] - ねこぼーろ
再生 - Perfume
Something More - Ralph
小さなてのひら - riya
My Special Day - Dew
圆 - AGA
Highway Driving Car - etsuco
琥珀の身体 - HIMEHINA
还是分开 - 张叶蕾
Harmonics  - 雄之助 / GUMI / 巡音ルカ / CircusP
愛されたい…愛してる?with AZU - K.J. with AZU
一起吹过晚风的街 - 聂思诗
蛍 - はりーP / 初音ミク
くちなしの言葉 - みゆな
京华旧梦 - 西二
夏日循环 - 西二
双人行 - 西二
巷子和树 - 西二
告白の夜 - Ayasa绚沙
砂塵の彼方へ - Revo / 梶浦由記
夜撫でるメノウ（翻自 Ayase）  - 春下れいな
Trouble I'm In - Twinbed
六等星の夜 - Aimer
誰にだって訳がある - ハルレオ
さよならくちびる - ハルレオ
Flying High - Trazh
pop/stars (K/DA Cover) - Seraphine
Dreaming Alone - Against the Current / TAKA
自我 - 乐思言
Sold Out - Hawk Nelson
Shine - 家入レオ
回到夏天 - 傲七爷 / 小田音乐社
Difficult - Jay Bombay / NEIMY
三月は夜の底 - 古川本舗
未完待续 - 云龙军惠 / 诗岸
Peaceful Sleep (From "NieR: Automata") - Simnoid
Starry Night - Couple N
Sparks Fly - Taylor Swift
自由の代償 - 石元丈晴
Why - 絢香
Goodbye Happiness - 宇多田ヒカル
At The Edge - 千坂
MELANCHOLY - White Cherry
まもりたい ～White Wishes～ (Tales of Graces Version) - BoA
时钟（特别版） - 丁芙妮
ひと - 遊助
Dr.サニーデイの哲学 - IA / dezzy
一笑懸命 - 遊助
inside you - milet
愛唄~since 2007~ - whiteeeen
stranger_think - C418
アーカイブに保存した曲 - ちゃんみな
差不多姑娘 - G.E.M.邓紫棋
戒烟 - 李荣浩
熬夜成瘾 - 朱兴东
Perfect World - Akinobu
白夜（Cover 尹姝贻） - 凯瑟喵
一个 - 陈壹千
Uz - Orangestar / IA
歌に形はないけれど - doriko / 初音ミク
それがあなたの幸せとしても - 巡音ルカ / Heavenz
蜜蜂 - 王贰浪
画 (Live Piano Session II) - G.E.M.邓紫棋
The Loneliest Girl - Nai Br.XX / Celeina Ann
木桥小谣 - 音阙诗听 / 赵方婧
木桥小谣 - 音阙诗听 / 昆玉
木桥小谣 - 音阙诗听 / 王梓钰
旧雨 - 封茗囧菌
时扣 - 清风之恋 / 初音ミク
繁华唱遍（泠鸢翻唱版）（翻自 乐正绫 调教：纳兰寻风）  - 泠鸢yousa
人间不值得 - 黄诗扶
Butter-fly - TetraCalyx
ReReハロ~終われそうにない夏~ - seven oops
한겨울의 숨바꼭질 - T-ara
トモダチ/コイビト - moumoon
回る空うさぎ - Orangestar / 初音ミク
Firefly - A*Teens
血 - 神前暁 / 帆足圭吾
Moon Without The Stars - Quiana
Beautiful - CREAM
COLORFUL - 大間々昂
茜さす - Aimer
ぶれないアイで - 初音ミク / Mitchie M
砂時計 - 夢乃ゆき
宅旅行 - 孙怡
조으다 완전 조으다（翻自 Hari）  - 很美味
Memories - ローラ
妄想感傷代償連盟 - DECO*27 / 初音ミク
また君と - JAY'ED / Ms.OOJA
君の知らない物語 - supercell
風に薫る夏の記憶 - AAA
さよならのゆくえ - 瀧川ありさ
dark cherry mystery - 水橋かおり
「私は何も知りませんよ。あなたが知っているんです-阿良々木先輩。」 - 羽岡佳
やっぱり - 羽岡佳
月牙湾 - F.I.R.
リセットの呪文 - Salley
Memories Gone By - park bird
谎（无念白版） - 凯瑟喵
トリビア - 神前暁
过客 - 周思涵
駅 - Tiara
永遠 - BoA
Born for More - Jenna Davis
Sweetie - Carly Rae Jepsen
Superstar - Beatrich
喜欢 - 阿肆
Libertus - Chen-U
空は高く風は歌う - 春奈るな
会いたい - Naomile
I’m Fine - Emily Hearn
I Wanna Go - MACO
TO BE．．． - 吉川友
if（翻自 丁可） - 顾西奇
and I... - ももちひろこ
マインドブランド - MARETU / 初音ミク
Distance -voice & piano- - 和紗
Tomorrow With You - Senpai / Kondor
and my life turned around - olli
Bittersweet Chocolate - mr. hong
Bloom of Youth - Key Sounds Label
年少有为 - 李荣浩
will you marry me ? - marlboro.
still missing you - MiChi
a cute date - elijah who
I see - eyelis
こたえ - 安田奈央
Think Again - Kate Havnevik
カイネ - MONACA
Endless Road - fumika
Don't say "lazy" - 桜高軽音部
願い~あの頃のキミへ~ Acoustic ver. - 當山みれい
Invisible One - 松倉サオリ
EXEC_COSMOFLIPS/. - KOKIA
一夜未眠君知否 - 简吟 / 千月兔 / 小吴太太 / 钟祺源 / IRiS七叶 / 甘璐
Weight of the World/壊レタ世界ノ歌 - 河野マリナ
Weight of the World (English Version) - J'Nique Nicole
遊園施設 - 帆足圭吾
遺サレタ場所/斜光 - 岡部啓一
顕現シタ異物 - 岡部啓一 / 帆足圭吾
穏ヤカナ眠リ - 岡部啓一
退 - 曲肖冰
かざぐるまの恋 - fifi léger(ゆうり)
春、恋、花以外の（除了春天爱情和樱花 日文cover）（翻自 IU） - 栗川舜 / 匀子 / ClessS
PON PON PON - 鏡音レン
青花引 (甜美solo版) - Ace组合
SAKURAリグレット - Flower
はじめまして - ラブリーサマーちゃん
AMAZING ME - WHITE JAM
Who Do You Love? - Sweet Licious
疏远 - 刘初寻 (二逗)
洛阳夜雨 - HITA
ここにいるよ - Goose house
for you（翻自 AZU） - 火西肆
君のとなり - 當山みれい
杏花弦外雨 - CRITTY / 司夏
カノン - DJ Okawari
Never Over (feat. Michi) - BEAUZ / Michi
You Smile - Eternity ∞
in your arms - saib.
Canals - Joakim Karud
ラプンツェル（Cover 初音ミク） - 芝麻Mochi
It's my way - Tiara
光 - 當山みれい
彼女は旅に出る - 鎖那
안녕 - 孝琳
Sacred Play Secret Place - Matryoshka
春意盎然图 - Pig小优
寄明月（Cover SING女团 / 乐正绫） - 三无MarBlue / 泠鸢yousa
Dramatic Walk -Album Ver - koyori / 初音ミク
CANDY CANDY - GUMI
紫阳花 - Dew
why, or why not - 片霧烈火
oblivious - Kalafina
時雨 - 川嶋あい
梅雨明けの - じっぷす / 初音ミク
feel feat. tada aoi - project-ALCA-
あなたがいた森 - 樹海
カラフル - H△G
桜色舞うころ - 中島美嘉
HIKARI - ELISA
秘密 - RAM WIRE
Ever After - Alice
Headlight - MONKEY MAJIK
終わりの世界から - やなぎなぎ
This Is the Life - Angie Miller
金魚花火 - 大塚愛
好きだよ。~100回の後悔~ (English Ver.) - Che'Nelle
ALIVE - RAM WIRE
あなたを想いたい - 米澤円
After All ～綴る想い～ - 上原れな
ナミダノコエ - Sotte Bosse
僕らの手には何もないけど、 - RAM WIRE
東京 - 山崎あおい
PROMiSE - MiChi
Bila - Candy
ハッピーシンセサイザ - GUMI / 巡音ルカ / EasyPop
夏恋花火 - 40mP / GUMI
届かない恋 - 上原れな
夢笑顔 - 茶太
アキラブ - Juliet
君に最後の口づけを - majiko
어쩌다 - Brown Eyed Girls
if... - mink
MY ALL - 浜崎あゆみ
Rage your dream - m.o.v.e
岁时记 - 依穆炎 / 引月兮 / 兔裹煎蛋卷 / 鸱
Nico - advantage Lucy
なのです! - ななひら / 宇佐美宏 / void
perfect slumbers - 堀江由衣
HOME - CHIHIRO
君だったら - HAPPY BIRTHDAY
レゾンデートルの花 - 40mP
Glitter (Starving Trancer Remix) - 森永真由美 / Another Infinity
いつか - Wonder-K / 初音ミク
朝焼けターミナル ( STARS REMIX) - ひさしろ
朝焼けのスターマイン - 今井麻美
花降らし - n-buna / 初音ミク
Prime number~君と出会える日~ - 大倉明日香
이층침대 (Good Night) - 宇宙少女
アイロニ - H△G
花に赤い糸 - 麻倉もも
君が夢を連れてきた - ペットな彼女たち
Each and All - 及川リン / livetune
ビードロ模様 - やなぎなぎ
distance - 詩音
嘘 - 宮脇詩音
願い~あの頃のキミへ~ - 當山みれい
Star Story - livetune / 初音ミク
LIGHT - NIKIIE
Smile again - 40mP / 初音ミク / GUMI
カゲロウ - Stack
あなたに出会わなければ~夏雪冬花~ - Aimer
雨き声残響 - Orangestar / IA
lyric - 茶太
drop - keeno / 初音ミク
幸せですか - 川嶋あい
ONE's hope - やなぎなぎ
黒猫 - 花たん
消せない気持ち - Kicco
ユメノナカ - 山崎あおい
Cynic - 闇音レンリ / ポリスピカデリー
100年后のきみに - LOVE
いつもこの場所で - 彩音
ワールド・ワイド・ボクシステム - Annabel
夕日坂 - 花たん
歌に形はないけれど - 花たん
Love Game - Licana
私の好きなもの - ラブリーサマーちゃん
ユメ - Arisa
からっぽの街月夜の下 - Orangestar / 初音ミク
Alive (Original Mix) - Krewella
Fallin - Manami
SAKURA - WITCH NUMBER 4
愛唄～since 2007～ - whiteeeen
8 - keeno / 初音ミク
Stolen - MAKAI
dance DANCE! - MiChi
アンブレラ - なゆごろう
time to go! - ベッキー♪＃
電話 - 山崎あおい
君の知らない物語 - supercell
もうじき夏が終わるから - n-buna / 初音ミク
ありがとう... - KOKIA
忘れたくて… - 山口リサ
暧昧さ回避 - ポリスピカデリー / 闇音レンリ
ルミネセンス - ラブリーサマーちゃん
Mr.Music - れるりり / 巡音ルカ / 鏡音リン / 鏡音レン / 初音ミク / 歌愛ユキ / GUMI
SAKURA - Che'Nelle
scrape - keeno / 初音ミク
歩み - RAM WIRE
Mermaid girl (Extended RRver.) - 森永真由美
キセキ~未来へ~ - whiteeeen
Re:ナミダボシ feat. CLIFF EDGE - 詩音
1/6 - ぼーかりおどP / 初音ミク
眠れないほど - 真崎ゆか / WISE
蛍 - 向日葵
キセキ - ケラケラ
さよならのこと - 上原れな
恋はヒラひらり - Goose house
落日 - 茶太
粉雪、フワリ. - Lily.μ
WHITE ALBUM - 冬馬かずさ
PLANET - ラムジ
弱虫モンブラン - DECO*27 / GUMI
愛言葉 - DECO*27 / 初音ミク
Hand in Hand - livetune / 初音ミク
おじゃま虫 - DECO*27 / 初音ミク
裏表ラバーズ×ロストワンの号哭 - 初音ミク / 鏡音リン / wowaka / Neru
ユラユラ - BENI
大地に咲く旋律 - 幽閉サテライト
Désir - GARNiDELiA
白雪 ~sirayuki~ - とのん
ごはんを食べよう - Goose house
終わりの世界から - やなぎなぎ
葉桜 - 北乃きい
きみにとどけ - 佐藤亜美菜
キミと見た花 キミと見た空 -full ver.- - 東山奈央 / 大地葉
深海少女 - のぶなが
I hate me - Lily.μ
逢うたび好きになって - BRIGHT
庭園にて。 - acane_madder
コネクト - ClariS
irony - ClariS
ヒトリゴト - ClariS
アイル - Machico
Best of my Love - 安田レイ
灼け落ちない翼 - 多田葵
baby don't know why - Ms.OOJA
Always Getting Over You - Angela Ammons
fluffy - 大坪由佳
打上花火 - Daoko / 米津玄師
Chapter.5 - Larval Stage Planning
ECHO（五人唱见双声道/ShakingHigh Remix） - ShakingHigh
ここにいるわ - Ms.OOJA
Rising Girl (Radio Version) - Lovestoned
花降らし - pazi
Endless Tears - CLIFF EDGE
dear... - 高橋未奈美
Open your eyes - 亜咲花
chAngE - miwa
Meant To Be - J-Hype
Mad Sexy Cool - Babyface
月灯り - CHI-KA
The Saltwater Room - Owl City / Breanne Düren
TO BE... - 吉川友
忘れたくて… - 山口リサ
Re:make - ONE OK ROCK
East of Eden - Zella Day
Good Time - Owl City / Carly Rae Jepsen
Jocelin - Leddra Chapman
Unbelievable - Owl City / Hanson
Payphone - Maroon 5 / Wiz Khalifa
All We Know - The Chainsmokers / Phoebe Ryan
Cold Ain't For Me - Oceans
Trip - Axero
我喜欢上你时的内心活动 - 陈绮贞
Ordinary Day - Melanie Penn
what for? - sAr
My dream - 夏小舟
追光者 - 岑宁儿
Dandan心魅かれてく(渐渐被你吸引) - FIELD OF VIEW
No One But You - Doug Paisley
The Day You Went Away - M2M
Proud Of You - 冯曦妤
I Really Like You - Carly Rae Jepsen
Stitches - Shawn Mendes
Reality - Lost Frequencies / Janieck
Way Back Into Love (Demo) - Hugh Grant / Drew Barrymore
A Little Love - 冯曦妤
I Could Be the One - Donna Lewis
Shots (Broiler Remix) - Imagine Dragons / Broiler
无归 - 叶里
Demons - Imagine Dragons
Cruisin - Sioen
那年夏天宁静的海 - 王心凌
瀘沽寻梦 - 银临
Summer Vibe (Pegato Remix) - Pegato / Walk off the Earth
Stronger - Inez
Shades Of Grey (DFLV Remix) - DFLV / Oliver Heldens / Shaun Frank / Delaney Jane
意外 - 薛之谦
遇见你的时候所有星星都落到我头上 - 高姗
ハロ/ハワユ - ナノウ / 鹿乃
夜の国 - Annabel
远走高飞 - 金志文
不是故意 - By2
Unpredictable - Olly Murs / Louisa Johnson
想太多 - 李玖哲
Beautiful In White (Demo) - Shane Filan
Heartbeats - Amy Deasismont
Fuerteventura - Russian Red
好可惜 - 庄心妍
Sixteen - Chelsea Cutler
告白气球 - 周杰伦
そばにいるね - SoulJa
Viva La Vida - Coldplay
山外小楼夜听雨 - 任然
你好陌生人 - 任然
放过自己 - 庄心妍
GALLOWS BELL - F9
あの頃～ジンジンバオヂュオニー～ - whiteeeen
パズル - ENE
絆 - miu-clips
下个，路口，见 - 李宇春
アイロニ - majiko
Try - P!nk
Daydreamer (Original Mix) - KarlK / guitk
Something Just Like This (feat. Romy Wave) - Anthony Keyrouz / Romy Wave
Victory - Two Steps From Hell
Sing Me to Sleep - Alan Walker
Nevada - Vicetone / Cozi Zuehlsdorff
Summertime - K-391
いつも何度でも - 宗次郎
風の住む街 - 磯村由紀子
Don't Wanna Know/We Don't Talk Anymore - Sam Tsui / Alex Blue
Rain after Summer - 羽肿
Everything - Yinyues
The Right Path - Thomas Greenberg
Chiru (Saisei no Uta) - Robert de Boron
Letter - iris
Luv Letter - DJ Okawari
Utakata - 阿南亮子
Refrain - 阿南亮子
You Don't Know Me - Ofenbach
Flemington - Tom Day
The Ocean - Mike Perry / SHY Martin
Monody (Radio Edit) - TheFatRat / Laura Brehm
Galway Girl (Decoy! Remix) - Decoy! / Ed Sheeran
Visions - Acreix
Life - Tobu
I Do - 911
You’ll Be Mine - Havana Brown / R3HAB
The #IcePack Rises (Original Mix) - EnV
The Ocean (Radio Edit) - Mike Perry / SHY Martin
Pneumatic Tokyo - EnV
那年初夏 - 任然
Because You Live - Jesse McCartney
Look Back - Tone Damli Aaberge
凉城 - 任然
Because of You - Josh Vietti
Take Me Back - Christopher / Matoma
Where Is the Love - Josh Vietti
别再来梦里 - 谢沛恩
和你一样 - 李宇春
Bye Bye Bye - Lovestoned
Hall of Fame - The Script / will.i.am
River Flows In You - Martin Ermen
Innocence - Avril Lavigne
Tassel - Cymophane
When You're Gone - Avril Lavigne
Complicated - Avril Lavigne
Lone Ranger - Rachel Platten
错的人 - 萧亚轩
明天，你好 - 牛奶咖啡
王源生贺-浮木（翻自 Elisa） - KANATA雪 / 缪木弯弯 / 悠然然
It's Obvious - Emma Stevens
我也很想他 - 孙燕姿
原点 - 孙燕姿 / 蔡健雅
Big Big World - Emilia
She - Groove Coverage
A Place Called You - Emma Stevens
Ça Ira - Joyce Jonathan
Better in Time - Leona Lewis
Everytime - Britney Spears
Nothing on you - 邓福如 AFÜ
Gotta Have You - The Weepies / Deb Talan / Steve Tannen
Sku' Ha' Gået Hjem - Sys Bjerre
Astral Requiem - 山下直人
Fell for U - Noicybino
一生有你 - 水木年华
淘汰 - 陈奕迅
好久不见 - 陈奕迅
Crazy Bird - Wild Child
不要说话 - 陈奕迅
Sofía - Álvaro Soler
Yes or No - AGA
Anonymous - Noicybino
仓颉（Cover 五月天 Acoustic Ver.） - Cannie
Sky (Radio Edit) - Steerner / Martell
La Vida Seguirá - Álvaro Soler
Need You Now (iTunes Session) - Lady A
Packed - AGA
一直很安静 - 阿桑
她说 - 林俊杰
What Are Words - Chris Medina
Traveling Light - Joel Hanson / Sara Groves
Intro - The xx
The Things About Tears - AGA
Here With You - Asher Monroe
Es rappelt im Karton - Pixie Paris
Valder Fields - Tamas Wells
Hello - OMFG
Hymn For The Weekend [Remix] - Alan Walker / Coldplay
I wanted you - Ina Wroldsen
U Make Me Wanna - Blue
Miss You Tonight - 茶小姐和熊先生
Croatian Rhapsody - Maksim Mrvica
Me and My Broken Heart - Push Baby
Apologize - OneRepublic
原谅 (Cover 张玉华) - 刘瑞琦
Light & Your Story - 千坂
Wonderful U (Demo Version) - AGA
Jar Of Love - 曲婉婷
Fragments - 千坂
房间 - 刘瑞琦
走在冷风中 - 二珂
Fade - Alan Walker
遇见 - 孙燕姿
Free Loop - Daniel Powter

